; Trains and Time Travel starter map
; Legend: # wall, . floor/path, = train line, T train door, P player start, h road,
;         C car, S shop, N townsperson, M station master, B bench, K kiosk, ~ grass, D door,
;         X locked door, U stairs,
;         - platform edge, A announcement board, L lamp, V vending machine,
;         G luggage, R ticket barrier, O station clock
; Keep rectangular. The engine pads short rows with walls if needed.
================================================================================
================================================================================
################################################################################
#..............................................~~~~~~~.........................#
#........................---------TTTTTTTTTTTTT--------........................#
==================================T.....P.....T=================================
#........................---------TTTTTTDTTTTTT--------.......#######W######...#
#...........L.................A.................O......MV.....##..........##...#
#.............................................................X...........##...#
#..................................##########.................##......U...##...#
#.......RR..........G.........................................##..........##...#
#......................BBBB...................................##..........##...#
#.............................................................#######W######...#
#.......CCCCCCCC...........................................########............#
#.......C......C...........................................#......#............#
#.......C......C......................N....................#..S...#............#
#.......CCCCCCCC...........................................#......#............#
#..........................................................D......#............#
#..........................................................########............#
#..............................................................................#
#............................~~~~~~~~~~~~~~~~~~~...............................#
#............................~~~~~~~~~~~~~~~~~~~...............................#
#.............N..............~~~~~~~~~~~~~~~~~~~...............N....###........#
#...................................................................E.#........#
#......................................#####W#####..................###........#
#......................................#.........#.............................#
#..................####W###............W...S.....#.............................#
#..................#......#............#...Y.....W.............................#
#..................W..S...D............D.........#.............................#
#..................########............##W#####W##.............................#
hhhhhhhhhhhhhhhhhhhhhhhhhhhhhhhhhhhhhhhhhhhhhhhhhhhhhhhhhhhhhhhhhhhhhhhhhhhhhhhh
hhhhhhhhhhhhhhhhhhhhhhhhhhhhhhhhhhhhhhhhhhhhhhhhhhhhhhhhhhhhhhhhhhhhhhhhhhhhhhhh
################################################################################
